1111111111
100C000001
100000P001
100E000C01
1111111111
