1111111111
1E0C000P01
1111111111
