111111111111111111111111111111111111111111111111111111111111111111
100C0000000000000000000000C000000000000111110000111100000000000001
11000001101111111110000000C00011111000C000000011111110P00001111101
11111100CC1110000E000000111110C00011111111111111111111111111110001
1CC000000000000111100000000C10000000000000000000000000000000000001
111111111111111111111111111111111111111111111111111111111111111111
