11111111111111111111111111111111111111111111111111111111111
100C0000000000000000000000C00000000000011111000011110000001
11000001101111111110000000C00011111000C000000011111110P0101
11111100CC1110000E000000111110C0001111111111111111111111001
1CC000000000000111100000000C1000000000000000000000000000001
11111111111111111111111111111111111111111111111111111111111
