1111111111111111
1000P0000C000001
10001E0000000001
1110100111000001
10001100C11C0001
1001C00000111101
10C10011100C0001
1001001C00011111
1110100111000001
10001100C11C0001
1001C00000111101
10C10011100C0001
1001001C10011111
1000000000000C01
10C10011100C0001
1001001C10011111
1000000000000C01
10C10011100C0001
1001001C10011111
1000000000000C01
1111111111111111
