1111111111
1PC0EM0M01
1111111111
