111111111
10C000001
1000P0111
1000001E1
111111111
