111111111
100P00001
100000111
100000101
111111111
